#############.......
#########...#.......
#.......#...#.......
#.......##.##.......
#.......#...#.......
#...#.......#.......
#.......#...#.......
#.......###-#.......
#.......#.#.#.......
##-########.#.......
#....#......#.......
#....#...####.......
#....#...-..#.......
#......####.#.......
###########.#.......
#...#.#.....#.......
#...###.....#.......
#....-......#.......
#.#####.....#.......
#...#.#.....#.......
#.....##############
#...#.#######.....##
##-##.######.......#
#...#.######.......#
#...#.-............#
#...########.......#
##.#..######.......#
###...#######.....##
####################