.........222222.....
.........2....2.....
.........2....2.....
.........2....2.....
.........2....2.....
.........2....2.....
.........22.222.....
........3...........
.......3............
2222222.............
2.....2.............
2.....1.............
2.....2.............
2....22.............
2222222.............
....................
....................
....................
....................
....................